 1,  5,  5,  5,  5,  5,  5,  5,  5,  5,  5,  5,  5,  5,  5,  5,  5,  5,  5,  2,
 6,  0,  0,  0,  0,  0,  0,  0,  0,  0,  0,  0,  0,  0,  0,  0,  0,  0,  0,  6,
 6,  0,  0,  0,  0,  0,  0,  0,  0,  0,  0,  0,  0,  0,  0,  0,  0,  0,  0,  6, 
 6,  0,  0,  0,  0,  0,  0,  0,  0,  0,  0,  0,  0,  0,  0,  0,  0,  0,  0,  6,
 6,  0,  0,  0,  0,  0,  0,  0,  0,  0,  0,  0,  0,  0,  0,  0,  0,  0,  0,  6,
 6,  0,  0,  0,  0,  0,  0,  0,  0,  0,  0,  0,  0,  0,  0,  0,  0,  0,  0,  6,
 6,  0,  0,  0,  0,  0,  0,  0,  0,  0,  0,  0,  0,  0,  0,  0,  0,  0,  0,  6,
 6,  0,  0,  0,  0,  0,  0, 13, 14, 14, 14, 14, 15,  0,  0,  0,  0,  0,  0,  6,
 6,  0,  0,  0,  0,  0,  0,  0,  0,  0,  0,  0,  0,  0,  0,  0,  0,  0,  0,  6,
 6,  0,  0,  0,  0,  0,  0,  0,  0,  0,  0,  0,  0,  0,  0,  0,  0,  0,  0,  6,
 6,  0, 16,  9,  0,  0,  0,  0,  0,  0,  0,  0,  0,  0,  0,  0, 10, 17,  0,  6,
 6,  0,  0, 12,  9,  0,  0,  0,  0,  0,  0,  0,  0,  0,  0, 10, 11,  0,  0,  6,
 6,  0,  0,  0, 12,  9,  0,  0,  0,  0,  0,  0,  0,  0, 10, 11,  0,  0,  0,  6,
 6,  0,  0,  0,  0, 12,  9,  0,  0,  0,  0,  0,  0, 10, 11,  0,  0,  0,  0,  6,
 3,  5,  5,  5,  5,  5,  5,  5,  5,  5,  5,  5,  5,  5,  5,  5,  5,  5,  5,  4,